1111111111
1000C11011
1000101X11
1001010P01
10CCCC0E01
1CCCCCC001
1111111111
