1111111111
1000C11011
10001CCE11
1001010PC1
10CCCC0001
1CCCCCC001
1CCCCCCCC1
1CCCCCC011
1CCCCCC011
1CCCCCC011
1111111111
