11111111111111111111
1XXXXXXXXXXXXXXXXXX1
1XPX0CXCXXX0X0000X01
1X0XCXXCCXXCXXXXEXX1
1X0X00X0X0X000XX0XX1
1X0XX0X0X0XXX0000001
1X0000000000000C00X1
1XXXX0XXXXX0XXXXXXX1
11111111111111111111
