11111111
10000P11
11111011
10CCC001
1E000001
11100011
100CC001
11111111
