111111111111111111111111111
1P1000C00000000000000C00111
101000111111110000000000001
1000001C0011C11111111100C01
100C11000000E000C0000000011
111111111111111111111111111
