1111111111
1000C1E001
10001CCC11
10010100C1
1PCCCC0001
1CCCCCC001
1CCCCCCCC1
1CCCCCC011
1CCCCCC011
1CCCCCC011
1111111111
