11111111111111111111111111
1000000000000000000000P001
10110001000000000000001001
10000000000110000110001001
10110011000110000110001001
1011000100011CCCC110001001
10111111000000000000001001
1000000000000000000000E001
11111111111111111111111111
