111111111111111111111111111
101001001010101000000010101
10100000C00CCCCCCCCCCCCCC11
1P0001010010000010100100001
101E01010010000010100100001
111111111111111111111111111
