1111111111111
1P0000000C011
10000C0000111
100000X0CE011
1111111111111